000000000000000
000000000000000
000000000000000
000000000000000
000000000000000
000000000000000
000000000000000
000000000000000
000000000000000
000000100000000
000000000000000
111111110111111
000000010100000
000000010100000
000000010100000