0000000000000000000000000000000000000000000000000000000000000
0000000000000000000000000000000000000000000000000000000000000
0000000000000000000000000000000000000000000000000000000000000
0000000000000000000000000000000000000000000000000000000000000
0000000000000000000000000000000000000000000000000000000000000
1111111111111111111111111111111111111111111111111000000000000
0000000000000001000000000000000000000000000000001000000000000
0000000000000001000000000000000000000000000000001000000000000
0000000000000001111111110000000000000000000000001000000000000
0000000000000001000000000000000000100000000000001000000000000
0000000000000001000000000000000000100000000000001000000000000
0000000000000001000000001000000011100000000000001000000000000
0000000000000001000000001000000000000000000000001000000000000
0000000000000001000000001110000000000000000000001000000000000
0000000000000001000000000000000000000000000000001000000000000
0000001000000001000000000000000000000000000000001000000000000
0000000000000000000000000000000000000000000000001000000000000
1111111101111111011111110111110111111101111111111000000000000
0000000101000000000000000000000000000000000000001000000000000
0000000101000001111111110111110111111101111111111000000000000
0000000101000001000000000000000000000000000000001000000000000
0000000101000001000000000000000000000000000000001000000000000
1111111111111111111111111111111111111111111111111000000000000